#############################S##
#                              #
# ############ ############### #
# #                          # #
# # ######## ############### # #
# # #                        # #
# # # ############ ######### # #
#   # #              #   # # # #
##### # ################ #   # #
# # # # #  #           # # ### #
#   #   # ## ######### # # # # #
# # # ### #  #   #   # #   #   #
# # # # # # #  #   # # # # # # #
# # # # # # ######## # ### # # #
# # # # # #          # # # # # #
# # # # # ### ###### #   # ### #
# # # # # # #      # # # #   # #
# # ###   # ###### # # # # # # #
# # # # # # #      ##### # # # #
# # #   # # # ######   # ### # #
# # # # # #          # # # # # #
# # # # # ############ # # # # #
# # # ###    #         #   # # #
# # # # ### ##### ###### # # # #
# # # #           #      # # ###
# # # #################### # # #
# # #         #            # # #
# # ## ############### # ### # #
# #    #               #       #
# ######## ###### ############ #
#               #              #
##E#############################
